1,1,1,1,1,1,1,1,1,1
1,0,0,0,0,0,0,0,0,1
1,0,0,0,0,0,0,0,0,1
1,0,999,0,0,0,0,997,0,1,0,2
1,1,1,1,1,1,1,1,1,1